....C....C.........bb...........................
....C...C....C.....bb...........................
1C2C.C...C...C...C.bb...........................
........C..C.......bb...........................
.....C........b....bb...........................