.........bb............F........................
..........b..C.....CC..F........................
1F2......b...C...C.CC..F........................
........b..C...........F........................
.....b.....b..b....CC..F........................